sample_id	group_label
/n/rinn_data1/seq/lgoff/Projects/BrainMap/data/quants/JR858/abundances.cxb	linc-Brn1a
/n/rinn_data1/seq/lgoff/Projects/BrainMap/data/quants/JR859/abundances.cxb	linc-Brn1a
/n/rinn_data1/seq/lgoff/Projects/BrainMap/data/quants/JR860/abundances.cxb	linc-Brn1a
/n/rinn_data1/seq/lgoff/Projects/BrainMap/data/quants/JR758/abundances.cxb	linc-Brn1b
/n/rinn_data1/seq/lgoff/Projects/BrainMap/data/quants/JR764/abundances.cxb	linc-Brn1b
/n/rinn_data1/seq/lgoff/Projects/BrainMap/data/quants/JR808/abundances.cxb	linc-Brn1b
/n/rinn_data1/seq/lgoff/Projects/BrainMap/data/quants/JR809/abundances.cxb	linc-Cox2
/n/rinn_data1/seq/lgoff/Projects/BrainMap/data/quants/JR816/abundances.cxb	linc-Cox2
/n/rinn_data1/seq/lgoff/Projects/BrainMap/data/quants/JR829/abundances.cxb	linc-Cox2
/n/rinn_data1/seq/lgoff/Projects/BrainMap/data/quants/JR787/abundances.cxb	Eldr
/n/rinn_data1/seq/lgoff/Projects/BrainMap/data/quants/JR810/abundances.cxb	Eldr
/n/rinn_data1/seq/lgoff/Projects/BrainMap/data/quants/JR838/abundances.cxb	Eldr
/n/rinn_data1/seq/lgoff/Projects/BrainMap/data/quants/JR752/abundances.cxb	linc-Enc1
/n/rinn_data1/seq/lgoff/Projects/BrainMap/data/quants/JR770/abundances.cxb	linc-Enc1
/n/rinn_data1/seq/lgoff/Projects/BrainMap/data/quants/JR839/abundances.cxb	linc-Enc1
/n/rinn_data1/seq/lgoff/Projects/BrainMap/data/quants/JR751/abundances.cxb	Manr
/n/rinn_data1/seq/lgoff/Projects/BrainMap/data/quants/JR772/abundances.cxb	Manr
/n/rinn_data1/seq/lgoff/Projects/BrainMap/data/quants/JR788/abundances.cxb	Manr
/n/rinn_data1/seq/lgoff/Projects/BrainMap/data/quants/JR754/abundances.cxb	Haunt
/n/rinn_data1/seq/lgoff/Projects/BrainMap/data/quants/JR767/abundances.cxb	Haunt
/n/rinn_data1/seq/lgoff/Projects/BrainMap/data/quants/JR759/abundances.cxb	Haunt
/n/rinn_data1/seq/lgoff/Projects/BrainMap/data/quants/JR773/abundances.cxb	Celrr
/n/rinn_data1/seq/lgoff/Projects/BrainMap/data/quants/JR760/abundances.cxb	Celrr
/n/rinn_data1/seq/lgoff/Projects/BrainMap/data/quants/JR763/abundances.cxb	Celrr
/n/rinn_data1/seq/lgoff/Projects/BrainMap/data/quants/JR793/abundances.cxb	Crnde
/n/rinn_data1/seq/lgoff/Projects/BrainMap/data/quants/JR790/abundances.cxb	Crnde
/n/rinn_data1/seq/lgoff/Projects/BrainMap/data/quants/JR830/abundances.cxb	Crnde
/n/rinn_data1/seq/lgoff/Projects/BrainMap/data/quants/JR775/abundances.cxb	Kantr
/n/rinn_data1/seq/lgoff/Projects/BrainMap/data/quants/JR747/abundances.cxb	Kantr
/n/rinn_data1/seq/lgoff/Projects/BrainMap/data/quants/JR812/abundances.cxb	Kantr
/n/rinn_data1/seq/lgoff/Projects/BrainMap/data/quants/JR749/abundances.cxb	Trp53cor
/n/rinn_data1/seq/lgoff/Projects/BrainMap/data/quants/JR814/abundances.cxb	Trp53cor
/n/rinn_data1/seq/lgoff/Projects/BrainMap/data/quants/JR862/abundances.cxb	Trp53cor
/n/rinn_data1/seq/lgoff/Projects/BrainMap/data/quants/JR721/abundances.cxb	Peril
/n/rinn_data1/seq/lgoff/Projects/BrainMap/data/quants/JR718/abundances.cxb	Peril
/n/rinn_data1/seq/lgoff/Projects/BrainMap/data/quants/JR720/abundances.cxb	Peril
/n/rinn_data1/seq/lgoff/Projects/BrainMap/data/quants/JR792/abundances.cxb	Peril
/n/rinn_data1/seq/lgoff/Projects/BrainMap/data/quants/JR757/abundances.cxb	Tug1
/n/rinn_data1/seq/lgoff/Projects/BrainMap/data/quants/JR857/abundances.cxb	Tug1
/n/rinn_data1/seq/lgoff/Projects/BrainMap/data/quants/JR861/abundances.cxb	Tug1
/n/rinn_data1/seq/lgoff/Projects/BrainMap/data/quants/JR753/abundances.cxb	WT
/n/rinn_data1/seq/lgoff/Projects/BrainMap/data/quants/JR750/abundances.cxb	WT
/n/rinn_data1/seq/lgoff/Projects/BrainMap/data/quants/JR771/abundances.cxb	WT
/n/rinn_data1/seq/lgoff/Projects/BrainMap/data/quants/JR755/abundances.cxb	WT
/n/rinn_data1/seq/lgoff/Projects/BrainMap/data/quants/JR811/abundances.cxb	WT
/n/rinn_data1/seq/lgoff/Projects/BrainMap/data/quants/JR768/abundances.cxb	WT
/n/rinn_data1/seq/lgoff/Projects/BrainMap/data/quants/JR761/abundances.cxb	WT
/n/rinn_data1/seq/lgoff/Projects/BrainMap/data/quants/JR815/abundances.cxb	WT
/n/rinn_data1/seq/lgoff/Projects/BrainMap/data/quants/JR789/abundances.cxb	WT
/n/rinn_data1/seq/lgoff/Projects/BrainMap/data/quants/JR762/abundances.cxb	WT
/n/rinn_data1/seq/lgoff/Projects/BrainMap/data/quants/JR774/abundances.cxb	WT
/n/rinn_data1/seq/lgoff/Projects/BrainMap/data/quants/JR746/abundances.cxb	WT
/n/rinn_data1/seq/lgoff/Projects/BrainMap/data/quants/JR748/abundances.cxb	WT
/n/rinn_data1/seq/lgoff/Projects/BrainMap/data/quants/JR716/abundances.cxb	WT
/n/rinn_data1/seq/lgoff/Projects/BrainMap/data/quants/JR717/abundances.cxb	WT
/n/rinn_data1/seq/lgoff/Projects/BrainMap/data/quants/JR719/abundances.cxb	WT
/n/rinn_data1/seq/lgoff/Projects/BrainMap/data/quants/JR756/abundances.cxb	WT
